0i0i0i0i0i0i
0i0i0i0i0i0i
0i0iws0i0i0i
0i0i0i^i<i0i
0i0i0i0ias0i
0i0i0i0i0i0i