0i0i0i0i0i0i
0i0i0i>i0ivi
0i0irsai0i0i
0i0i0i0i0i<i
0i0iws0i0i0i
0i0i0i0i0i0i