0irsvi0i0i0i
0i0i>ivi0i0i
0i0iai0i0i0i
0i0i0i0i0i0i
0i0iws0i0i0i
0i0i0i0i0i0i