0i0i0i0i0i0i
0i0i0i0i0i0i
0i0i0i0i0i0i
0i0i>i0i0i0i
0i0ias0iws0i
0i0i0i0i0i0i