0i0i0i0i0i0i
0i0ivi0i0i0i
0irsai0i0i0i
0i0i0i0i0i0i
0iws0i0i0i0i
0i0i0i0i0i0i